000000000000000000000000000000000000000000000000000000000000000000000000000000000000000
000000000000000000000000000000000000000000000000000000000000000000000000000000000000000
000000000000000000000000000000000000000000000000000000000000000000000000000000000000000
000000000000000000000000000000000000000000000000000000000000000000000000000000000000000
000000000000000000000000000000000000000000000111111111111111000000000000000000000000000
000000000000000000000000000000000000000000000511111111111511000000000000000000000000000
000000000000000000000000000000000000000011111100000000000011000000000000000000000000000
000000000000000000030050000000000000000011111100000505000000000000005000000000000000000
000005000050000000000000005000000000000000000000111111111110000000000000005000000000000
000000015000000000000003000000000000000000000000000000000011000003000000000000000000901
000000111500001111111111111111100000000111110000000000000000001111011110111111111111111
111116111311111311111111111111111111111111111111111111111111111111111113111111111111111
111111111111111111111111111111111111111111111111111111111111111111111111111111111111111