000000000000000000000000000000000000000000000000000000000000000000000000000000000000000
000000000000000000000000000000000000000000000000000000000000000000000000000000000000000
000000000000000000000000000000000000000000000000000000000000000000000000000000000000000
000000000000000000000000000000000000000000000000000000000000000000000000000000000000000
000000000000000000000000000000000000000000000111111111111111000000000000000000000000000
000000000000000000000000000000000000000000000511111111111511000000000000000000000000000
000000000000030000000000000000000000000000001100000555000011000000000000000000000000000
000000000001111111000050000000000000000000000000000505000000000000005000000000000000000
000000000050050000000000005350000300000001111000111111111000000000000005500000000000000
000000000000050000500000000000000000000010000000000005000011000003000010000000000000901
0000001100110011111111111011111100005000111016110005000000000001111011110111111111111111
111111113111113111111111311111111111111111111111111111111111111111111113111111111111111
111111111111111111111111111111111111111111111111111111111111111111111111111111111111111