000000000000000000000000000000000000000000000000000000000000000000000000000000000000000
000000000000000000000000000000000000000000000000000000000000000000000000000000000000000
000000000000000000000000000000000000000000000000000000000000000000000000000000000000000
000000000000000000000000000000000000000000000000050000000555000000000000000000000000000
000000000000000000500000000000000000500000000000010111111111000000000000000000000000000
000000000000000000005000000005050505000000000511110111111511000000000000000000000000000
000000000000000001110000000111111111111111111100000555000011000000000000000000000000000
000000000000003000000050001100011100000000000000000505000000000000000000000000000000000
000000000050001000000000011000030000000001111110111111111110000000000000055000000000000
000000000010000000560000111000050000000010050050000005000011000053000010000000000000901
000000111111111111111101111113000500011165000000005000000000001111000010111101111111111
111111111111113333311131311111111111111111111111111111111111111111013113111111111111111
111111111111111111111111111111111111111111111111111111111111111111111111111111111111111